5;6
0;0;0;0;0
1;1;0;0;1
2;2;0;0;4
1;3;4;0;4
0;1;0;0;4
0;2;2;0;2